Maequitube	Montipora
Mcapitata	Montipora
Ahyacinthu	AntiMontipora
Amillepora	AntiMontipora
Adigitifer	AntiMontipora
Acervicorn	AntiMontipora
Apalmata	AntiMontipora
Atenuis	AntiMontipora
Gacrhelia	Galaxia
Gastreata	AntiGalaxia
Pastreoide	Porites
Paustralie	Porites
Plobata	Porites
Gcolumna	AntiPorites
Shystrix	Pocilloporid
Spistillat	Pocilloporid
Pdamicorni	Pocilloporid
Mauretenra	Pocilloporid
Pcarnosus	AntiPocilloporid
Pdaedalea	AntiPocilloporid
Ofaveolata	AntiPocilloporid
Pstrigosa	AntiPocilloporid
Mcavernosa	AntiPocilloporid
Fscutaria	AntiPocilloporid